10 10
1 4
9 10
2 2 1 2 X 2 8 2 2 2
7 2 2 4 X 4 6 X X 2
X 3 X X 3 X 2 3 1 7
2 2 3 X 5 2 X 1 X 4
5 2 2 6 2 3 X 2 2 X
5 3 2 4 2 X 1 3 X 1
7 1 1 6 X 3 X 5 4 1
X 5 1 X X X X 1 1 4
1 6 3 4 1 4 3 2 4 1
X 3 3 1 3 1 2 1 6 2