10 10
10 10
1 1
2 2 1 1 2 X 3 3 2 X
2 1 X 5 X 1 1 1 3 3
1 2 5 2 8 X 6 4 2 X
4 X 1 4 4 3 4 1 3 2
2 4 4 5 1 4 2 X X X
5 X 3 3 X X 2 1 7 6
1 6 2 3 2 5 2 1 3 3
X 5 X 1 6 2 1 2 X 1
2 2 4 2 2 5 1 4 3 X
3 1 X 1 1 2 8 X 3 2